.	.
,	,
w	w
i	i
się	się
na	na
nie	nie
z	z
-	-
do	do
to	to
–	–
"	"
że	że
jest	jest
?	?
o	o
a	a
jak	jak
:	:
po	po
ale	ale
)	)
(	(
tak	tak
za	za
co	co
od	od
by	by
przez	przez
em	em
tym	tym
czy	czy
już	już
!	!
no	no
m	m
dla	dla
ma	ma
tylko	tylko
może	może
są	są
tego	tego
bo	bo
było	było
jego	jego
był	był
ja	ja
też	też
ze	ze
jeszcze	jeszcze
będzie	będzie
ich	ich
śmy	śmy
oraz	oraz
być	być
bardzo	bardzo
jej	jej
roku	roku
ten	ten
mnie	mnie
jednak	jednak
tam	tam
przy	przy
tej	tej
sobie	sobie
pan	pan
go	go
które	które
który	który
lub	lub
mi	mi
pod	pod
przed	przed
była	była
nawet	nawet
lat	lat
można	można
teraz	teraz
więc	więc
jako	jako
także	także
mu	mu
1	1
gdy	gdy
żeby	żeby
te	te
bez	bez
tu	tu
kiedy	kiedy
2	2
;	;
nad	nad
tych	tych
coś	coś
pracy	pracy
on	on
miał	miał
r	r
nas	nas
która	która
jeśli	jeśli
wszystko	wszystko
mam	mam
mówi	mówi
gdzie	gdzie
właśnie	właśnie
takie	takie
u	u
niż	niż
również	również
pani	pani
były	były
aby	aby
kto	kto
których	których
nic	nic
nich	nich
3	3
ci	ci
którzy	którzy
trzeba	trzeba
ta	ta
ją	ją
chyba	chyba
albo	albo
potem	potem
we	we
którym	którym
wiem	wiem
mają	mają
dwa	dwa
będą	będą
wtedy	wtedy
zł	zł
powiedział	powiedział
dobrze	dobrze
nim	nim
osób	osób
raz	raz
je	je
jeżeli	jeżeli
więcej	więcej
ludzi	ludzi
zawsze	zawsze
kilka	kilka
siebie	siebie
wiesz	wiesz
jestem	jestem
”	”
przecież	przecież
ona	ona
„	„
domu	domu
taki	taki
jeden	jeden
czyli	czyli
polsce	polsce
dzieci	dzieci
ani	ani
miała	miała
bardziej	bardziej
sposób	sposób
ty	ty
im	im
proszę	proszę
życia	życia
polski	polski
ś	ś
dziś	dziś
nam	nam
której	której
dlatego	dlatego
sam	sam
chciał	chciał
wczoraj	wczoraj
został	został
wszystkich	wszystkich
czas	czas
5	5
innych	innych
4	4
między	między
wiele	wiele
pana	pana
wszystkie	wszystkie
mogą	mogą
temu	temu
dlaczego	dlaczego
panie	panie
niego	niego
eś	eś
czasu	czasu
życie	życie
gdyby	gdyby
podczas	podczas
ktoś	ktoś
dwóch	dwóch
swoje	swoje
ponad	ponad
państwa	państwa
wielu	wielu
ust	ust
tys	tys
ludzie	ludzie
trochę	trochę
wszystkim	wszystkim
sprawie	sprawie
choć	choć
oczywiście	oczywiście
którego	którego
dopiero	dopiero
miasta	miasta
ustawy	ustawy
dni	dni
nigdy	nigdy
tutaj	tutaj
trzy	trzy
niej	niej
musi	musi
aż	aż
pierwszy	pierwszy
proc	proc
mógł	mógł
czym	czym
dnia	dnia
jakby	jakby
tyle	tyle
jakie	jakie
czasie	czasie
razem	razem
chodzi	chodzi
art	art
lecz	lecz
później	później
prostu	prostu
należy	należy
mamy	mamy
nikt	nikt
wszyscy	wszyscy
miejsce	miejsce
według	według
chce	chce
oni	oni
10	10
jednym	jednym
znaczy	znaczy
tę	tę
inne	inne
każdy	każdy
poza	poza
wcześniej	wcześniej
byli	byli
razie	razie
kraju	kraju
taka	taka
6	6
mieć	mieć
np	np
temat	temat
natomiast	natomiast
my	my
coraz	coraz
strony	strony
30	30
rady	rady
najbardziej	najbardziej
około	około
takich	takich
masz	masz
naprawdę	naprawdę
związku	związku
dzień	dzień
jakiś	jakiś
kilku	kilku
świata	świata
wśród	wśród
dziękuję	dziękuję
dużo	dużo
często	często
dalej	dalej
jakieś	jakieś
ile	ile
chwili	chwili
stanie	stanie
mimo	mimo
rzeczy	rzeczy
dzięki	dzięki
spraw	spraw
mowa	mowa
ul	ul
powiedzieć	powiedzieć
cały	cały
lata	lata
m.in	m.in
takiego	takiego
swoich	swoich
prawo	prawo
iż	iż
dzisiaj	dzisiaj
pytanie	pytanie
osoby	osoby
dwie	dwie
komisji	komisji
prawie	prawie
została	została
przykład	przykład
mieli	mieli
ogóle	ogóle
ok	ok
prawa	prawa
20	20
minister	minister
latach	latach
one	one
nr	nr
część	część
człowiek	człowiek
polska	polska
części	części
cię	cię
miejscu	miejscu
wiadomo	wiadomo
przede	przede
15	15
bowiem	bowiem
rok	rok
człowieka	człowieka
pewno	pewno
wie	wie
wobec	wobec
polskiej	polskiej
mówił	mówił
którą	którą
kiedyś	kiedyś
jedynie	jedynie
7	7
niech	niech
nią	nią
niestety	niestety
poseł	poseł
mln	mln
czego	czego
swoją	swoją
koniec	koniec
sytuacji	sytuacji
mniej	mniej
oczy	oczy
słowa	słowa
jaki	jaki
przypadku	przypadku
trzech	trzech
polskich	polskich
mogę	mogę
raczej	raczej
ziemi	ziemi
—	—
8	8
złotych	złotych
lepiej	lepiej
ponieważ	ponieważ
udział	udział
zrobić	zrobić
pierwsze	pierwsze
powinien	powinien
obok	obok
rzecz	rzecz
prawda	prawda
swoim	swoim
mój	mój
tysięcy	tysięcy
polskiego	polskiego
takim	takim
12	12
nowe	nowe
firmy	firmy
mało	mało
trudno	trudno
pieniądze	pieniądze
l	l
yyy	yyy
zdaniem	zdaniem
samo	samo
swój	swój
policji	policji
jednej	jednej
szkoły	szkoły
wieku	wieku
końcu	końcu
zupełnie	zupełnie
centrum	centrum
długo	długo
śmierci	śmierci
większość	większość
prezydenta	prezydenta
obecnie	obecnie
sprawy	sprawy
jesteś	jesteś
ii	ii
wreszcie	wreszcie
końca	końca
pieniędzy	pieniędzy
pomocy	pomocy
warszawie	warszawie
zostanie	zostanie
rząd	rząd
czasem	czasem
miejsca	miejsca
sobą	sobą
udało	udało
taką	taką
ciągu	ciągu
zgodnie	zgodnie
będę	będę
mogli	mogli
informacji	informacji
nadal	nadal
szybko	szybko
zbyt	zbyt
jednego	jednego
s	s
wraz	wraz
prezydent	prezydent
zaś	zaś
wydaje	wydaje
tą	tą
drodze	drodze
nowego	nowego
dziecko	dziecko
chwilę	chwilę
różnych	różnych
/	/
naszych	naszych
uwagę	uwagę
partii	partii
cztery	cztery
chciała	chciała
zresztą	zresztą
drzwi	drzwi
sld	sld
myśli	myśli
świecie	świecie
dość	dość
akcji	akcji
jedno	jedno
sprawa	sprawa
jedna	jedna
świat	świat
naszej	naszej
samym	samym
sąd	sąd
swojej	swojej
km	km
chociaż	chociaż
celu	celu
początku	początku
pewnie	pewnie
inaczej	inaczej
przeciw	przeciw
gminy	gminy
brak	brak
moje	moje
ciebie	ciebie
drugi	drugi
tzw	tzw
razy	razy
wówczas	wówczas
myślę	myślę
zaraz	zaraz
gdzieś	gdzieś
widać	widać
%	%
nasze	nasze
zdrowia	zdrowia
nagle	nagle
kultury	kultury
życiu	życiu
program	program
możemy	możemy
kobiety	kobiety
mogła	mogła
drugiej	drugiej
będziemy	będziemy
pierwszym	pierwszym
andrzej	andrzej
godz	godz
powiedziała	powiedziała
głos	głos
nowy	nowy
zwłaszcza	zwłaszcza
mówię	mówię
nocy	nocy
ojciec	ojciec
wniosek	wniosek
powodu	powodu
przeciwko	przeciwko
jesteśmy	jesteśmy
zostały	zostały
ręce	ręce
sama	sama
